1111111111111111
1501010000010001
1001010000010001
1001010000010001
1001010100010001
1011010100110001
1000010100000001
1000010100000001
1000000110000001
1111111100011101
1000001000010001
1000001000010001
1001111000010001
1000000000010001
1000000000010061
1111111111111111